1111111111
1P000C0001
1001000001
1001111111
1001000001
1001000001
1001000C01
1001001001
1C00C00001
1111111111