1111111111111111111111111111111
1P00000000000000000000000010001
100000000000011110000000000C001
100000000000E000000C00000010001
100000001000000000000C000010001
1111111111111111111111111111111